111111111111
1P0000000001
1E00000C0001
111111111111