1111111111111
1P000000001C1
10000E0000011
1111111111111