1111111111111
1000000000001
1P000100001C1
10001E0000001
1111111111111